MMMMMMMMMMMMMMMMMMMMMMMMMMMMMMMM
MPTTRTTTTTRTTTRTTTTTTTRTTTTRTTTM
MTTTTTTRTTTTRTRTRTTTTTRTTTDTTTTM
MTTRTTTTRTTTTTTTTTRTTRTRTTTTRTTM
MTTTTRTTTRTTRDTRTRTDTTDTTTRTTTTM
MTTTTDTTTTTTTTTRTTTTTTTTTTTTTRTM
MMMMMMMMMMMMMMMMTTTTTTTTRDTTTTTM
MTTTTTTTTTTTRTTTTTTTRRTTTTTRTTTM
MTTTTTTTTDTTTTTTTDTTTTTTTTTTRTTM
MTTTTTTTTTTRTTTRTTTTTTTRTTTTDTTM
MTTRTTTTTTTTTTTTTTTTTTTTRTRTTRTM
MTRDRTTTTTRTTTTTRTTTRTRTTTTRTTTM
MTTTTMMMMMMMMMMMMMMMMMMMMMMMMMMM
MTTRTTTTTTTTRDRTTTTTTTTTRTRTRTRM
MTTTTTTTTTTTTTTTTRDRTTTTTRTRTRTM
MMMMMMMMMMMMMMMMMMMMMMMMMMMMMMMM