MMMMMMMMMMMMMMMMMMMMMMMMMMMMMMMM
MPTTTTTTTMTTRTTRTTTDTTRTTTTTRTTM
MTTTTRRTTMTTDTTTRTTTTTTRTTTRRTTM
MTTTTTTRTMTTTRTTTTRTTTTRDTTTDTTM
MTTTTTDTTMTRTTTTRTRTTTRTRTTTTTTM
MTTTRTTRTMTTTTTRDTTMTTTRTTTTTTRM
MRRTTTRTTMTRTTTTTRTMTTTTTTTTRTTM
MTTTTRTRTMTTTDTTRTTMTTDTTTRTDTTM
MTTTTTTTTMTTTTTTTTTMRTTTRTTTTTRM
MTRTTDTTTMTRTRTTTRTMTTTRTTTTTTTM
MTTTTTTTRTTTTTDTTTTMTTTTTTRDTTTM
MTTTTRTTTTRTTTTTTRTMTTRTTTTTTRTM
MTTDTTTTTRTTTTRRTTTMTTTDTRTTTTTM
MTRTTTRTTRTTRTRDRTTMTRTTTTTRTTTM
MTTTRTTTDTTTTTTTTRTMTTTTTTTTRTTM
MMMMMMMMMMMMMMMMMMMMMMMMMMMMMMMM