MMMMMMMMMMMMMMMMMMMMMMMMMMMMMMMM
MPTTRTTTTRTTTRTTMTTTRDTTTTTRRRTM
MTTTTTRTTDRTTTTTMDTTRRTRTTTRDTTM
MTTTTRTTRTRTTTTRMRTTRTTTTRTTTTTM
MRRDTTTRTTDTTRTT TTTTTTTTRTTTRTM
MTTTRTTTTTTTTTTTMTRTTTRRTTTRTTTM
MTTTTDRTTTTTRTTTMTDTTTRDRTTTTRTM
MTRTTTTRTTRTTTDTMTTTTTRTTTRTTTTM
MMM MMMMMMMMM MMMMM MMMMMMMM MMM
MTTTRTRTTTDRTTRRMTTTTRTRTTTTTTTM
MRTTRDTTTTRTRTDRMTRDTTTTTRTTDTTM
MTTTTTRRRTTTTRTRMRTTRTTTTRRTTTRM
MRTTRTRTTTTRRTTT TTTTDTTTTTTRTTM
MTRTRTTTTTTTRTTRMTTRRRRTTTRTDTTM
MTDTTTRTTRTTTDRTMTTRTTDTRTTTTTTM
MMMMMMMMMMMMMMMMMMMMMMMMMMMMMMMM